    changePokemonButton: "Cambia Pokémon",
    searchBattle: "Cerca Lotta",

    wantToBattle: "Vuoi iniziare una lotta?",
    waitForPlayer: "In attesa di altri giocatori...",

    noTeam: "Non possiedi una squadra.",
    TeamFainted: "Ricerca fallita. Tutti i tuoi Pokémon sono esausti",

    // battle
    battlePlayerNotAccepted: "Il tuo avversario ha perso connessione prima che la lotta iniziasse.<br><br>Per favore prova di nuovo.",
    battleCancelled: "La lotta è stata annullata.",
    battleAlreadyEnded: "La lotta è già terminata.",
    battleWaitForPlayer: "In attesa di altri giocatori...",
    battleMoveUsed: (pokemonName, moveName) => `<span class="battle-log-pokemonname" style="color:#63ff78">${pokemonName}</span> usa <span class="battle-log-movename" style="color:#ff6374">${moveName}</span>.`,
    battleMoveFailed: "Fallisce.",
    battleAttackMissed: (pokemonName) => `L'attacco di <span class="battle-log-pokemonname" style="color:#63ff78">${pokemonName}</span> va a vuoto.`,
    battleNotEffective: "Non è molto efficace...",
    battleEffective: "È superefficace!",
    battleNoEffect: "Non ha effetto...",
    battleCriticalHit: "Brutto colpo!",
    battleNotAwaitingMove: "La mossa è già stata scelta.",
    battleMultipleHits: (amount) => `${amount} colpi!`,
    battleStatUp1: (pokemonName, statName) => `<span class="battle-log-pokemonname" style="color:#63ff78">${pokemonName}</span>'s ${statName} aumenta.`,
    battleStatUp2: (pokemonName, statName) => `<span class="battle-log-pokemonname" style="color:#63ff78">${pokemonName}</span>'s ${statName} aumenta di molto!`,
    battleStatUp3: (pokemonName, statName) => `<span class="battle-log-pokemonname" style="color:#63ff78">${pokemonName}</span>'s ${statName} sale al massimo!`,
    battleStatDown1: (pokemonName, statName) => `<span class="battle-log-pokemonname" style="color:#63ff78">${pokemonName}</span>'s ${statName} diminuisce.`,
    battleStatDown2: (pokemonName, statName) => `<span class="battle-log-pokemonname" style="color:#63ff78">${pokemonName}</span>'s ${statName} diminuisce di molto!`,
    battleStatDown3: (pokemonName, statName) => `<span class="battle-log-pokemonname" style="color:#63ff78">${pokemonName}</span>'s ${statName} scende al minimo!`,

    // status effects
    battleEnemySleeping: (pokemonName) => `<span class="battle-log-pokemonname" style="color:#63ff78">${pokemonName}</span> si è addormentato.`,
    battleEnemyParalysis: (pokemonName) => `<span class="battle-log-pokemonname" style="color:#63ff78">${pokemonName}</span> è stato paralizzato.`,
    battleEnemyPoison: (pokemonName) => `<span class="battle-log-pokemonname" style="color:#63ff78">${pokemonName}</span> è stato avvelenato.`,
    battleEnemyToxic: (pokemonName) => `<span class="battle-log-pokemonname" style="color:#63ff78">${pokemonName}</span> è stato avvelenato gravemente.`,
    battleEnemyBurned: (pokemonName) => `<span class="battle-log-pokemonname" style="color:#63ff78">${pokemonName}</span> è stato bruciato.`,
    battleIsParalyzed: (pokemonName) => `<span class="battle-log-pokemonname" style="color:#63ff78">${pokemonName}</span> è paralizzato e non può muoversi.`,
    battleEnemyConfused: (pokemonName) => `<span class="battle-log-pokemonname" style="color:#63ff78">${pokemonName}</span> entra in stato di confusione.`,
    battleEnemyEndConfusion: (pokemonName) => `<span class="battle-log-pokemonname" style="color:#63ff78">${pokemonName}</span> non è più confuso.`,
    battleEnemyFrozen: (pokemonName) => `<span class="battle-log-pokemonname" style="color:#63ff78">${pokemonName}</span> è stato congelato.`,
    battleIsSleeping: (pokemonName) => `<span class="battle-log-pokemonname" style="color:#63ff78">${pokemonName}</span> è addormentato e non può muoversi.`,
    battleConfused: (pokemonName) => `<span class="battle-log-pokemonname" style="color:#63ff78">${pokemonName}</span> è confuso e si colpisce da solo.`,
    battleIsFrozen: (pokemonName) => `<span class="battle-log-pokemonname" style="color:#63ff78">${pokemonName}</span> è congelato e non può muoversi.`,
    battleFlinched: (pokemonName) => `<span class="battle-log-pokemonname" style="color:#63ff78">${pokemonName}</span> tentenna e non può attaccare.`,
    battleHealed: (pokemonName) => `<span class="battle-log-pokemonname" style="color:#63ff78">I PS di ${pokemonName}</span> sono stati rigenerati.`,
    battleWokeUp: (pokemonName) => `<span class="battle-log-pokemonname" style="color:#63ff78">${pokemonName}</span> si è svegliato.`,
    battleUnthawed: (pokemonName) => `<span class="battle-log-pokemonname" style="color:#63ff78">${pokemonName}</span> si è scongelato.`,
    battleRecoilApplied: (pokemonName) => `<span class="battle-log-pokemonname" style="color:#63ff78">${pokemonName}</span> subisce contraccolpo.`,
    battlePoisonDamage: (pokemonName) => `<span class="battle-log-pokemonname" style="color:#63ff78">${pokemonName}</span> subisce danno da veleno.`,
    battleBurnDamage: (pokemonName) => `<span class="battle-log-pokemonname" style="color:#63ff78">${pokemonName}</span> subisce danno da scottatura.`,
    battlePokemonChanged: (LastPokemonName, CurrentPokemonName) => `<span class="battle-log-pokemonname" style="color:#63ff78">${LastPokemonName}</span> è stato cambiato con <span class="battle-log-pokemonname" style="color:#63ff78">${CurrentPokemonName}</span>.`,

    // field effects
    battleRainEnd: `Ha smesso di piovere`,
    battleRainStarted: `Inizia a piovere`,
    battleHailStarted: `Inizia a grandinare`,
    battleHailDamage: 'I Pokémon subiscono danno dalla grandine.',
    battleHailEnd: 'Ha smesso di grandinare.',
    battleSandstormStarted: "Ha inizio una tempesta di sabbia.",
    battleSandstormDamage: "I pokemon vengono danneggiati dalla tempesta di sabbia.",
    battleSandstormEnd: "La tempesta di sabbia è finita.",
    battleSunStarted: `Il sole splende intensamente.`,
    battleSunEnd: `Il sole si è affievolito.`,

    // battle ended
    BattleWin: "Congratulazioni, hai vinto la lotta!",
    BattleLose: "Hai perso la lotta!",
    BattleXP: (XP) => `La tua squadra ha ricevuto ${XP} XP!`,
    BattleNoXP: "La tua squadra non ha ricevuto XP!",
